{
    "0": 0,
    "1": 1,
    "2": 2,
    "3": 3,
    "4": 4,
    "5": 5,
    "6": 6,
    "7": 7,
    "8": 8,
    "9": 9,
    "10": 10,
    "11": 11,
    "12": 12,
    "13": 13,
    "14": 14,
    "15": 15,
    "16": 16,
    "17": 17,
    "18": 18,
    "19": 19,
    "20": 20,
    "21": 21,
    "22": 22,
    "23": 23,
    "24": 24,
    "25": 25,
    "26": 26,
    "27": 27,
    "28": 28,
    "29": 29,
    "30": 30,
    "31": 31,
    "32": 32,
    "33": 33,
    "34": 34,
    "35": 35,
    "36": 36,
    "37": 37,
    "38": 38,
    "39": 39,
    "40": 40,
    "41": 41,
    "42": 42,
    "43": 43,
    "44": 44,
    "45": 45,
    "46": 46,
    "47": 47,
    "48": 48,
    "49": 49,
    "50": 50,
    "51": 51,
    "52": 52,
    "53": 53,
    "54": 54,
    "55": 55,
    "56": 56,
    "57": 57,
    "58": 58,
    "59": 59,
    "60": 60,
    "61": 61,
    "62": 62,
    "63": 63,
    "64": 64,
    "65": 65,
    "66": 66,
    "67": 67,
    "68": 68,
    "69": 69,
    "70": 70,
    "71": 71,
    "72": 72,
    "73": 73,
    "74": 74,
    "75": 75,
    "76": 76,
    "77": 77,
    "83": 78,
    "84": 79,
    "85": 80,
    "86": 81,
    "87": 82,
    "88": 83,
    "89": 84,
    "90": 85,
    "91": 86,
    "92": 87,
    "93": 88,
    "94": 89,
    "95": 90,
    "96": 91,
    "97": 92,
    "98": 93,
    "99": 94,
    "100": 95,
    "101": 96,
    "102": 97,
    "103": 98,
    "104": 99,
    "105": 100,
    "106": 101,
    "107": 102,
    "108": 103,
    "109": 104,
    "110": 105,
    "111": 106,
    "112": 107,
    "113": 108,
    "114": 109,
    "115": 110,
    "116": 111,
    "117": 112,
    "118": 113,
    "119": 114,
    "120": 115,
    "121": 116,
    "122": 117,
    "123": 118,
    "124": 119,
    "125": 120,
    "126": 121,
    "127": 122,
    "128": 123,
    "129": 124,
    "130": 125,
    "131": 126,
    "132": 127,
    "133": 128,
    "134": 129,
    "135": 130,
    "136": 131,
    "137": 132,
    "138": 133,
    "139": 134,
    "140": 135,
    "141": 136,
    "142": 137,
    "143": 138,
    "144": 139,
    "145": 140,
    "146": 141,
    "147": 142,
    "148": 143,
    "149": 144,
    "150": 145,
    "151": 146,
    "152": 147,
    "153": 148,
    "154": 149,
    "155": 150,
    "156": 151,
    "157": 152,
    "158": 153,
    "159": 154,
    "160": 155,
    "161": 156,
    "162": 157,
    "163": 158,
    "164": 159,
    "165": 160,
    "166": 161,
    "167": 162,
    "168": 163,
    "169": 164,
    "170": 165,
    "171": 166,
    "172": 167,
    "173": 168,
    "174": 169,
    "175": 170,
    "176": 171,
    "177": 172,
    "178": 173,
    "179": 174,
    "180": 175,
    "181": 176,
    "182": 177,
    "183": 178,
    "184": 179,
    "185": 180,
    "186": 181,
    "187": 182,
    "188": 183,
    "189": 184,
    "190": 185,
    "191": 186,
    "192": 187,
    "193": 188,
    "194": 189,
    "195": 190,
    "196": 191,
    "197": 192,
    "198": 193,
    "199": 194,
    "200": 195,
    "201": 196,
    "202": 197,
    "203": 198,
    "204": 199,
    "205": 200,
    "206": 201,
    "207": 202,
    "208": 203,
    "209": 204,
    "210": 205,
    "211": 206,
    "212": 207,
    "213": 208,
    "214": 209,
    "215": 210,
    "216": 211,
    "217": 212,
    "218": 213,
    "219": 214,
    "220": 215,
    "221": 216,
    "222": 217,
    "223": 218,
    "224": 219,
    "225": 220,
    "226": 221,
    "227": 222,
    "228": 223,
    "229": 224,
    "230": 225,
    "231": 226,
    "232": 227,
    "233": 228,
    "234": 229,
    "235": 230,
    "236": 231,
    "237": 232,
    "238": 233,
    "239": 234,
    "240": 235,
    "241": 236,
    "242": 237,
    "243": 238,
    "244": 239,
    "245": 240,
    "246": 241,
    "247": 242,
    "248": 243,
    "249": 244,
    "250": 245,
    "251": 246,
    "252": 247,
    "253": 248,
    "254": 249,
    "255": 250,
    "256": 251,
    "257": 252,
    "258": 253,
    "259": 254,
    "260": 255,
    "261": 256,
    "262": 257,
    "263": 258,
    "264": 259,
    "265": 260,
    "266": 261,
    "267": 262
}