{
    "0": 0,
    "4": 1,
    "9": 2,
    "10": 3,
    "19": 4,
    "28": 5,
    "31": 6,
    "32": 7,
    "36": 8,
    "39": 9,
    "45": 10,
    "46": 11,
    "47": 12,
    "48": 13,
    "67": 14,
    "71": 15,
    "75": 16,
    "80": 17,
    "83": 18,
    "86": 19,
    "87": 20,
    "88": 21,
    "89": 22,
    "93": 23,
    "101": 24,
    "104": 25,
    "105": 26,
    "106": 27,
    "107": 28,
    "108": 29,
    "109": 30,
    "110": 31,
    "111": 32,
    "112": 33,
    "113": 34,
    "114": 35,
    "115": 36,
    "116": 37,
    "117": 38,
    "118": 39,
    "119": 40,
    "120": 41,
    "121": 42,
    "122": 43,
    "123": 44,
    "124": 45,
    "125": 46,
    "126": 47,
    "127": 48,
    "128": 49,
    "129": 50,
    "130": 51,
    "132": 52,
    "133": 53,
    "134": 54,
    "137": 55,
    "142": 56,
    "143": 57,
    "144": 58,
    "145": 59,
    "146": 60,
    "150": 61,
    "151": 62,
    "152": 63,
    "153": 64,
    "157": 65,
    "158": 66,
    "163": 67,
    "164": 68,
    "165": 69,
    "166": 70,
    "168": 71,
    "174": 72,
    "175": 73,
    "176": 74,
    "177": 75,
    "178": 76,
    "179": 77,
    "181": 78,
    "182": 79,
    "183": 80,
    "185": 81,
    "189": 82
}